NO ./texture/bluestone.xpm
SO ./texture/colorstone.xpm

WE ./texture/greystone.xpm

EA ./texture/redbrick.xpm
F 53,97,47





C 92,161,189



111111111111111111111111111111111111
100000000010000000000000000000000000
100000000010000000000000000000000001
100000011100000000000000000100000001
1000N00DDD00000000001000001110000001
10000001110000000000D000000000001111
1000000000000001D10010001D1000000001
100000000000000000000000000000000000
111111111111111111111111111111111111

