NO ./fdsafdsasdfafds
SO ./fdsafdsasdfafds

WE ./fdsafdsasdfafds

EA ./fdsafdsasdfafds
F 0,32,32
C 32,32,32


111111111111 111111111111
1000000000000000000000001
1111111111111111111111111111111111111
10000P00001000000000000D00111100000011
100000000010000000000001001   1000001  1
10000001110000000000000000111100000001
1000000DDD000000000000000000000000011
10000001110000000000010000000000001
100000000000000000000000000000000001
100000000000000000000000000000000001
100000000000000000000000000000000001
100000000000000000000000000000000001
100000000000000000000000000000000001
100000000000000000000000000000000001
100000000000000000000000000000000001
100000000000000000000000000000000001
100000000000000000000000000000000001
100000000000000000000000000000000001
100000000000000000000000000000000001
100000000000000000000000000000000001
100000000000000000000000000000000001
100000000000000000000000000000000001
100000000000000000000000000000000001
100000011100000000000000000000000001
100000010000000000000000000000000001
111111111111111111111111111111111111
11111111111							1
10000000011							1
11111111111							1