NO ./fdsafdsasdfafds
SO ./fdsafdsasdfafds

WE ./fdsafdsasdfafds

EA ./fdsafdsasdfafds
F 0,32,32





C 32,32,32


11
1
11111111111111111111111111111111111
100000000010000000000000000000000001
100000000010000000000000000000000001  1
1000000111000000000000000001000000001
1000P00DDD00000000001000001110000001
10000001110000000000D00000000000111
1000000000000000000010001D1000000001
100000000000000000000000000000000001
111111111111111111111111111111111111
11111111111							1
10000000011							1
11111111111							1

