NO ./texture/bluestone.xpm
SO ./texture/colorstone.xpm

WE ./texture/greystone.xpm

EA ./texture/redbrick.xpm
F 53,97,47





C 92,161,189


11100111111111111111111111111111111
100110000010000000000000000000000001
100000000010000000000000000000000001  1
1000000111000000000000000001000000001
0100S00DDD00000000001000001110000001
01000001110000000000D00000000000111
1000000000000001D10010001D1000000001
100000000000000000000000000000000001
111111111111111111111111111111111111
11111111111							1
10000000011							1
11111111111							1

