NO ./texture/bluestone.xpm
SO ./texture/colorstone.xpm

WE ./texture/greystone.xpm

EA ./texture/redbrick.xpm
F 53,97,47





C 92,161,189


1111111111111111111111111D11111111111111111111111111111111111111111111111111111
1000000000000000000000000000000000000000000000000000000000000000000000000000001
10000S0000000000000000000000000000000000000000000000000000000000000000000000001
1000000000000000000000000000000000000000000000000000000000000000000000000000001
1000000000000000000000000000000000000000000000000000000000000000000000000000001
1111111111111111111111111111111111111111111111111111111111111111111111111111111